R 800 800
NO ./textures/WALL65.xpm
SO ./textures/23f.xpm
WE ./textures/WALL33.xpm
EA ./textures/greywall.xpm
S ./textures/barrel.xpm
F 0   ,      0  ,         0
C 255   ,     255     , 255

        1111111111111111111111111
        1000000000110000000000001
        1011000001110000002000001
        1001000000000000000000001
111111111011000001110000000000001
1000000000110000011101111101111111111111111
11110111111111011100000010001
11110111111111011101010010001
11000000222222222222222220001
10020200000000110000001000001
10000000000000001101010010001
110000011101010111110111100111111
11110111 1110101 10111101000E00001
11111111 1111111 1111111111111111